0,1,0,1,0,1,0,1,0,1,0,1,0
2,1,2,1,2,1,2,1,2,1,2,1,2
3,1,3,1,3,1,3,1,3,1,3,1,3
4,1,4,1,4,1,4,1,4,1,4,1,4
0,1,0,1,0,1,0,1,0,1,0,1,0
2,1,2,1,2,1,2,1,2,1,2,1,2
3,1,3,1,3,1,3,1,3,1,3,1,3
4,1,4,1,4,1,4,1,4,1,4,1,4
0,1,0,1,0,1,0,1,0,1,0,1,0
2,1,2,1,2,1,2,1,2,1,2,1,2
3,1,3,1,3,1,3,1,3,1,3,1,3
4,1,4,1,4,1,4,1,4,1,4,1,4
0,1,0,1,0,1,0,1,0,1,0,1,0
2,1,2,1,2,1,2,1,2,1,2,1,2
3,1,3,1,3,1,3,1,3,1,3,1,3
4,1,4,1,4,1,4,1,4,1,4,1,4
0,1,0,1,0,1,0,1,0,1,0,1,0
2,1,2,1,2,1,2,1,2,1,2,1,2
3,1,3,1,3,1,3,1,3,1,3,1,3
4,1,4,1,4,1,4,1,4,1,4,1,4
0,1,0,1,0,1,0,1,0,1,0,1,0
2,1,2,1,2,1,2,1,2,1,2,1,2
3,1,3,1,3,1,3,1,3,1,3,1,3
4,1,4,1,4,1,4,1,4,1,4,1,4
0,1,0,1,0,1,0,1,0,1,0,1,0
2,1,2,1,2,1,2,1,2,1,2,1,2
3,1,3,1,3,1,3,1,3,1,3,1,3
4,1,4,1,4,1,4,1,4,1,4,1,4
0,1,0,1,0,1,0,1,0,1,0,1,0
2,1,2,1,2,1,2,1,2,1,2,1,2
3,1,3,1,3,1,3,1,3,1,3,1,3
4,1,4,1,4,1,4,1,4,1,4,1,4
0,1,0,1,0,1,0,1,0,1,0,1,0
2,1,2,1,2,1,2,1,2,1,2,1,2
3,1,3,1,3,1,3,1,3,1,3,1,3
4,1,4,1,4,1,4,1,4,1,4,1,4
0,1,0,1,0,1,0,1,0,1,0,1,0
2,1,2,1,2,1,2,1,2,1,2,1,2
3,1,3,1,3,1,3,1,3,1,3,1,3
4,1,4,1,4,1,4,1,4,1,4,1,4
0,1,0,1,0,1,0,1,0,1,0,1,0
2,1,2,1,2,1,2,1,2,1,2,1,2
3,1,3,1,3,1,3,1,3,1,3,1,3
4,1,4,1,4,1,4,1,4,1,4,1,4
0,1,0,1,0,1,0,1,0,1,0,1,0
2,1,2,1,2,1,2,1,2,1,2,1,2
3,1,3,1,3,1,3,1,3,1,3,1,3
4,1,4,1,4,1,4,1,4,1,4,1,4
0,1,0,1,0,1,0,1,0,1,0,1,0
2,1,2,1,2,1,2,1,2,1,2,1,2
3,1,3,1,3,1,3,1,3,1,3,1,3
4,1,4,1,4,1,4,1,4,1,4,1,4
0,1,0,1,0,1,0,1,0,1,0,1,0
2,1,2,1,2,1,2,1,2,1,2,1,2
3,1,3,1,3,1,3,1,3,1,3,1,3
4,1,4,1,4,1,4,1,4,1,4,1,4